english	turkish	property
steve ballmer	utkan topkan	noun
at the end of the day	günün sonunda	phrase
made my day	günümü yaptı	phrase
joseph silk	yusuf ipek	noun
decadance	dekadans	adj
ambitious	ambişöz	adj
for sure	emin için	phrase
susan	suzan	name
acceptable	makbul	adj
system	dizge	noun
terminal	uçbirim	noun
victor	muzaffer	noun
homer	zafer	noun
for fuck's sake	sikiş uğruna	phrase
somehow	biraznasıl	adv
to manage	idare etmek	verb
basement	bazman	noun
variety	varyete	noun
about it	o hakkında	phrase
strap-on	taksik	noun
black sabbath	kara sabahat	noun
blind guardian	görme engelli ceza infaz memuru	noun
transparency	şeffafiyet	noun
fuckery	sikiş fabrikası	noun
jesus fucking christ	isa'yı siken hrist	phrase
thread	tirad	noun
jesus christ	isa hrist	noun
life sucks	hayat sucukları	phrase
animal husbandry	hayvanları sikiştirmek	phrase
somewhat	birazne	adv
experience	eksperiyans	noun
pythonik	pitonik	noun
authorize	otorize	verb
we are back in town	şehircilikte geriyiz	verb phrase
deengage	degaj	verb
engage	angaj	verb
engaged	angaje	noun
engagement	angajman	noun
compost	komposto	noun
baseline	bazhat	noun
neural	nevral	adj
discourse	diskur	noun
basic	bazik	adj
creature	kreatür	noun
pantyhose	don hortumu	phrase
calendar	kalender	noun
scalability	sikilibilite	noun
raymond	ışınel	noun
intelligence	entelijans	noun
sick of tension	tansiyon hastası	noun phrase
after all	her şeyden sonra	phrase
anxious	anksiyöz	noun
french press	fransız basını	noun phrase
san sebastian	aziz sivaslı	proper noun
sebastian	sivaslı	noun
sebast	sivas	noun
punitive	pünitif	adj
chatgpt	çeto	proper noun
boilerplate	kaynama tabağı	noun
generic	jenerik	adj
chamberlain	otacı	noun
case	kase	noun
garbage	garbaj	noun
butcher	şarküter	noun
let that sink in	bırakın o lavabo içeri girsin	verb phrase
word of mouth	ağzın lafı	noun phrase
punchline	yumruk hattı	noun phrase
particularly	partikülerli	adv
smooth criminal	pürüzsüz suçlu	noun phrase
able abil	adj
capable	kapabil	adj
adem sandler	adem kumucu	proper noun
bucket	buket	noun
level headed	seviye kafalı	noun phrase
natural history	doğal tarih	noun phrase
cut the crap	boku kes	verb phrase
mindset	zihin kümesi	noun phrase
commodity	komodite	noun
village	vilaj	noun
beverage	beveraj	noun
four-door	fordor	noun(?)
summary	sümerya	noun
cooperation	kooperasyon	noun
cool story	serin hikaye	adj phrase
redflag	albayrak	noun
alright	tümsağ	noun
payment	payman	noun
database	databazı	noun
tension	tansiyon	noun
gentlemen	centilmenler	noun
manace	menas	noun
society	sosyete	noun
anyway	hiçyol	adv
ability	abiliyet	noun
meticulous	metikülöz	adj
